xxxxxxxxxxxx      xxxxxxxxxxxx
x                            x
x    m                  m    x
x                            x
x                            x
x      j           j         x
x                            x
x                       xxx  x
x                    x xx  x x
xxxxxxxxxxxx      xxxxxxxxxxxx
