xxxxxxxxxxxx      xxxxxxxxxxxx
x       m            m       x
x                            x
x                       m    x
x                            x
x     m        j             x
x                            x
x                            x
x                     xx     x
x                    x       x
xxxxxxxxxxxx      xxxxxxxxxxxx
