xxxxxxxxxxxx      xxxxxxxxxxxx
x                            x
x                            x
x      j            j        x
x     xxx          xxx       x
x                            x
x      m            m        x
x                            x
x                            x
xxxxxxxxxxxx      xxxxxxxxxxxx
