xxxxxxxxxxxx      xxxxxxxxxxxx
x       m            m       x
x                            x
x                            x
x                            x
x                            x
x        x          x        x
x      xx            xx      x
x   xxx                xxx   x
x                            x
xxxxxxxxxxxx      xxxxxxxxxxxx
